0000000000
0000000000
0000110000
0001111000
0011111100
0111111110
1111111111
