0000000000
0100000010
0000000000
0100000010
0010000100
0001111000
0000000000
